10 10
XXXXXXXXXX
X________X
XXXX_XX__X
X_____X__X
X_____XXXX
X________X
X________X
XXX_XXXXXX
XS_______X
XXXXXXXXXX